DBA	DBA
CON	CONNECT
RES	RESOURCE
ULT	UL_TBLSP
CVI	CREATE_VIEW
CMV	CREATE_MVIEW
CDL	CREATE_DB_LINK
CSE	CREATE_SESSION
CPR	CREATE_PROCEDURE
CTR	CREATE_TRIGGER
CSY	CREATE_SYNONYM
CTA	CREATE_TABLE
CSQ	CREATE_SEQUENCE
ASE	ALTER_SESSION
SAD	SELECT_ANY_DICTIONARY
SAT	SELECT_ANY_TABLE
UAT	UPDATE_ANY_TABLE
IAT	INSERT_ANY_TABLE
DAT	DELETE_ANY_TABLE
CAS	CREATE_ANY_SYNONYM
OEM	OEM_MONITOR
